{
  "tileAssets": {
  "0": "map_floor",
  "1": "map_wall"
},
  "layout": [
    [ 1,  1,  1,  1,  1,  1,  1,  1,  1,  1,  1,  1,  1,  1,  1,  1],
    [ 1,  0,  0,  1,  0,  1,  0,  0,  0,  0,  0,  0,  0,  0,  0,  1],
    [ 1,  0,  0,  0,  0,  1,  0,  0,  0,  0,  0,  0,  0,  0,  0,  1],
    [ 1,  0,  0,  1,  1,  1,  0,  0,  0,  0,  0,  0,  0,  0,  0,  1],
    [ 1,  0,  0,  1,  1,  0,  0,  0,  0,  0,  0,  0,  0,  0,  0,  1],
    [ 1,  0,  0,  1,  1,  0,  0,  0,  0,  0,  0,  0,  0,  0,  0,  1],
    [ 1,  0,  0,  1,  0,  0,  0,  0,  0,  0,  0,  0,  0,  0,  0,  1],
    [ 1,  0,  0,  1,  0,  1,  0,  0,  0,  0,  0,  0,  0,  0,  0,  1],
    [ 1,  0,  0,  1,  0,  1,  0,  0,  0,  0,  0,  0,  0,  0,  0,  1],
    [ 1,  0,  0,  1,  1,  1,  0,  0,  0,  0,  0,  0,  0,  0,  0,  1],
    [ 1,  0,  0,  0,  1,  1,  0,  0,  0,  0,  0,  0,  0,  0,  0,  1],
    [ 1,  0,  0,  0,  1,  1,  0,  0,  0,  0,  0,  0,  0,  0,  0,  1],
    [ 1,  0,  0,  0,  1,  1,  0,  0,  0,  0,  0,  0,  0,  0,  0,  1],
    [ 1,  0,  0,  0,  1,  1,  0,  0,  0,  0,  0,  0,  0,  0,  0,  1],
    [ 1,  0,  0,  0,  1,  1,  0,  0,  0,  0,  0,  0,  0,  0,  0,  1],
    [ 1,  1,  1,  1,  1,  1,  1,  1,  1,  1,  1,  1,  1,  1,  1,  1]
  ]
}