{
  "Width": 16,
  "Height": 16,
  "seed": 12345,
  "generationDate": "2025-08-24T14:39:02.561Z",
  "layout": [
    [1, 1, 1, 1, 1, 1, 1, 1, 1, 1, 1, 1, 1, 1, 1, 1],
    [1, 0, 0, 0, 1, 0, 0, 0, 0, 0, 0, -2, 0, 0, 0, 1],
    [1, 0, 0, 0, -2, 0, 0, 0, 0, 0, 0, -2, 0, 0, 0, 1],
    [1, 0, 0, 0, -2, 0, 0, 0, 0, 0, 0, 1, 0, 0, 0, 1],
    [1, 1, -2, 1, 1, 0, 0, 0, 0, 0, 0, 1, 1, 1, -2, 1],
    [1, 0, 0, 0, 0, 0, 0, 0, 0, 0, 0, 0, 0, -2, 0, 1],
    [1, 0, 0, 0, 0, 0, 0, 0, 0, 0, 0, 0, 0, 1, -2, 1],
    [1, 0, 0, 0, 0, 0, 0, 0, 0, 0, 0, 0, 0, 0, 0, 1],
    [1, 0, 0, 0, 0, 0, 0, 0, 0, 0, 0, 0, 0, 0, 0, 1],
    [1, 0, 0, 0, 0, 0, 0, 0, 0, 0, 0, 0, 0, 0, 0, 1],
    [1, 0, 0, 0, 0, 0, 0, 0, 0, 0, 0, 0, 0, 0, 0, 1],
    [1, 1, -2, 1, 1, 0, 0, 0, 0, 0, 0, 1, 1, -2, 1, 1],
    [1, 0, 0, 0, 1, 0, 0, 1, 1, -2, 1, 1, 0, 0, 0, 1],
    [1, 0, 0, 0, -2, 0, 0, -2, 0, 0, 0, -2, 0, 0, 0, 1],
    [1, 0, 0, 0, -2, 0, 0, -2, 0, 0, 0, -2, 0, 0, 0, 1],
    [1, 1, 1, 1, 1, 1, 1, 1, 1, 1, 1, 1, 1, 1, 1, 1]
  ]
}